W,W,W,W,W,W,W,W,W,W,W,W,W,W,W,W
W,K2,4, ,H,W, , , , , , , , , ,W
W, , , , ,W, ,5, , , , , , , ,W
W, , , , ,W, , , , , , , , , ,W
W, , , , ,B, , ,666, , , , , , ,W
W, , , , ,W, , , , , , , , , ,W
W, , , , ,W, , , , , , , , , ,W
W, , , , ,W, , , , , , , , , ,W
W, , , , ,W, , , , , , , , , ,W
W,W,W,W,W,W,W,W,W,W,W,W,W,W,W,W
