

1,1,VÝCHOD
W,W,W,W,W,W,W,W,W,W,W,W,W,W,W,W
W, ,4, ,H,W, , , , , , , , , ,W
W, , , , ,W, ,5, , , , , ,H, ,W
W, ,3, , ,W, , , , , , , , , ,W
W, , , , ,B, , ,66, , , , , , ,W
W, , , , ,W, , , , , , , , , ,W
W, , , , ,W, , , , , , , , , ,W
W, , , , ,W, , , , , , , , , ,W
W, , , , ,W, , , , , , , , , ,W
W,W,W,W,W,W,W,W,W,W,W,W,W,W,W,W
