W,W,W,W,W,W,W,W,W,W,W,W,W,W,W,W
W,K2, , , ,W, , , , , , , , , ,W
W, , , , ,W, ,5, , , , , , , ,W
W, , , , ,W, , , , , , , , , ,W
W, , , , ,B, , ,666, , , , , , ,W
W, , , , ,W, , , , , , , , , ,W
W, , , , ,W, , , , , , , , , ,W
W, , , , ,W, , , , , ,H, , , ,W
W, , , , ,W, , , , , , , , , ,W
W,W,W,W,W,W,W,W,W,W,W,W,W,W,W,W
