

1,1,VÝCHOD
W,W,W,W,W,W,W,W,W,W,W,W,W,W,W,W
W, ,4, ,H,W, , , , , , , , , ,W
W, , , , ,W, ,5, , , , , , , ,W
W, , , , ,W, , , , , , , , , ,W
W, , , , ,B, , ,666, , , , , , ,W
W, , , , ,W, , , , , , , , , ,W
W, , , , ,W, , , , , , , , , ,W
W, , , , ,W, , , , , , , , , ,W
W, , , , ,W, , , , , , , , , ,W
W,W,W,W,W,W,W,W,W,W,W,W,W,W,W,W
